aaron => erin, ron, ronnie
abel => ab, abe, eb, ebbie
abiel => ab
abigail => abby, gail, gail, nabby
abner => ab
abraham => ab, abe
abram => ab
adaline => ada, addy, delia, dell, lena
adelaide => addy, adele, dell, della, heidi
adeline => ada, addy, delia, dell, lena
adelphia => addy, adele, dell, delphia, philly
agatha => aggy
agnes => aggy, inez, nessa
aileen => allie, lena
alan => al
albert => al, bert
alberta => allie, bert, bertie
aldo => al
aldrich => rich, riche
alexander => al, alex, sandy
alexandra => alex, alla, sandra, sandy
alfonse => al
alfred => al, fred, freddy
alfreda => alfy, freda, freddy, frieda
alice => allie, elsie, lisa
alicia => allie, elsie, lisa
allan => al
allen => al
allisandra => allie
almena => allie, mena
alonzo => al, lon, lonzo
amanda => manda, mandy
amelia => amy, emily, mel, millie
anderson => andy
andrew => andy, drew
ann => annie, nan, nana, nancy, nanny
anne => annie, nan, nana, nancy, nanny
anthony => tony
antoinette => ann, netta, tony
antonia => ann, netta, tony
arabella => ara, arry, bella, belle
arabelle => ara, arry, bella, belle
archibald => archie
arlene => arly, lena
armena => arry, mena
arthur => art
asahel => asa
asaph => asa
asenath => assene, natty, sene
august => gus
augusta => aggy, gatsy, gussie, tina
augustina => aggy, gatsy, gussie, tina
augustine => august, austin, gus, gus
augustus => august, austin, gus
azariah => aze, riah
barbara => bab, babs, barby, bobbie
barnabas => barney
bartholomew => bart, bartel, bat, mees, meus
beatrice => bea, trisha, trix, trixie
belinda => belle, linda
benedict => ben, ben, bennie
benjamin => ben, benjy, bennie, jamie
bernard => barney, berney, bernie
bertha => bert, bertie, birdie
bill => fred
billy => fred
bradford => brad, ford
bridget => biddie, biddy, bridgie, bridie
broderick => brady, brody, rick, ricky
calvin => cal, vin, vinny
cameron => cam, ron, ron, ronny
camille => cammie, millie
carol => carrie, cassie, lynn
carolann => carol, carole
caroline => carol, carole, carrie, cassie, lynn
carolyn => carrie, cassie, lynn
casey => k.c.
cassandra => cassie, sandra, sandy
catherine => cassie, cathy, kathy, katy, kay, kit, kittie, lena, trina
cathleen => cassie, cathy, kathy, katy, kay, kit, kittie, lena, trina
cecilia => celia, cissy
cedric => ced, rick, ricky
charles => carl, charlie, chick, chuck, chuck
charlotte => char, lotta, lottie, sherry
chauncey => chan
chester => chet
christa => chris
christian => chris, chris, kit
christiana => ann, chris, christy, crissy, kris, kristy, tina
christina => chris, christy, crissy, kris, kristy, tina, tina
christine => chris, chrissy, crissy, kris, kristy, tina
christopher => chris, kit
clarence => clair, clare
clarinda => clara
clarissa => cissy, clara
clement => clem, clem
clifford => cliff, ford
clifton => cliff, tony
columbus => clum
conrad => con, conny
constance => connie
cordelia => cordy, delia
cornelia => cornie, corny, nelia, nelle, nelly
cornelius => con, conny, corny, niel
courtney => court, curt
curtis => curt
cynthia => cindy, cindy, cintha
cyrenius => cene, cy, renius, serene, swene
dal => dahl
dalton => dahl
daniel => dan, danny
darlene => darry, lena
david => dave, davey, day
debora => deb, debbie, debby
deborah => deb, debbie, debby
debra => deb, debbie
delbert => bert, del
deliverance => della, delly, dilly
delores => dee, dell, della, lola, lolly
dennis => denny
dennison => denny
derrick => eric, rick, rick, ricky
dicey => dicie
domenic => dom
dominic => dom
donald => don, donnie, donny, dony
dorcus => darkey
dorothy => dolly, dortha, dot, dotty
ebenezer => eb, ebbie, eben
edgar => ed, eddie, eddy
edith => edie, edie, edye
edmond => ed, eddie, eddy
edmund => ed, ed, eddie, eddy, ned, ted
eduardo => ed, eddie, eddy
edward => ed, eddie, eddy, ned, ted, teddy
edwin => ed, eddie, eddy, ned, win
edyth => edie, edye
edythe => edie, edye
elbert => albert
eleanor => elaine, ellen, ellen, ellie, lanna, lenora, nelly, nora
eleazer => lazar
elias => eli, lee, lias
elijah => eli, lige
eliphalet => left
elisha => eli, lish
elizabeth => bess, bessie, beth, betsy, betty, eliza, lib, libby, lisa, liz, liza, lizzie
ellswood => elsey
elmira => ellie, elly, mira
elouise => louise
elsie => elsey
elswood => elsey
elwood => woody
elze => elsey
emanuel => manny, manuel
emeline => em, emily, emma, emmy, milly
emily => emma, emmy, millie
epaphroditius => dite, ditus, dyce, dyche, eppa
ephraim => eph
eric => rick, ricky
ernest => ernie
estella => essy, stella
estelle => essy, stella
eugene => gene
evaline => eva, eve, lena
ezekiel => ez, zeke
ezra => ez
faith => fay
feltie => felty
ferdinand => ferdie, fred, freddie, freddy
fidelia => delia
florence => flo, flora, flossy
frances => cissy, fanny, fran, francie, frankie, frannie, franniey, sis
francine => fran, francie, frannie, franniey
francis => fran, fran, frank, frankie
franklin => fran, frank
franklind => frank
frederick => fred, fred, freddie, freddy, freddy, fritz
fredericka => freda, freddy, frieda, ricka
frieda => fred, freddie, freddy
gabriel => gabby, gabe
gabriella => ella, gabby
gabrielle => ella, gabby
genevieve => eve, jean, jenny
geoffrey => geoff, jeff
gerald => gerry, jerry
geraldine => dina, gerrie, gerry, jerry
gertrude => gert, gertie, trudy
gilbert => bert, bert, gil, wilber
gwendolyn => gwen, wendy
hannah => anna, nan, nanny
harold => hal, harry
harriet => hattie
helen => ella, ellen, ellie, lena
helene => ella, ellen, ellie, lena
heloise => eloise, elouise, lois
henrietta => etta, etty, hank, nettie, retta
henry => hal, hank, harry
hephsibah => hipsie
hepsibah => hipsie
herbert => bert, herb
hermione => hermie
hester => esther, hessy, hetty
hezekiah => hez, hy, kiah
hiram => hy
hopkins => hop, hopp
horace => horry
hubert => bert, bert, hub, hugh
ignatius => iggy, nace, nate, natius
irene => rena
irving => irv
isaac => ike, zeke
isabel => bell, bella, belle, ib, issy, nib, nibby, tibbie
isabella => bella, belle, ib, issy, nib, nibby, tibbie
isabelle => bella, belle, ib, issy, nib, nibby, tibbie
isadora => dora, issy
isidore => izzy
jacob => jaap, jake, jay, jay
jacobus => jacob
james => jamie, jem, jim, jimmie, jimmy
jane => janie, jean, jennie, jessie
janet => jan, jan, jessie
janice => jan
jean => jane, jeannie
jeanette => janet, jean, jessie, nettie
jeanne => jane, jeannie
jedidiah => jed
jefferson => jeff, sonny
jeffrey => geoff, jeff, jeff
jehiel => hiel
jemima => mima
jennifer => jennie
jeremiah => jereme, jerry
jessica => jessie
joan => jo, nonie
joann => jo
joanna => hannah, jo, joan, jody
joanne => jo
johanna => jo
johannah => hannah, joan, jody, nonie
john => jack, jock, johnny
jon => john, nathan
jonathan => john, nathan
joseph => jody, joe, joey, jos
josephine => fina, jo, jody, joey, josey
joshua => jos, josh
josiah => jos
joyce => joy
juanita => nettie, nita
judson => jud, sonny
julia => jill, julie
julian => jule
julias => jule
junior => jr, june, junie
kasey => k.c.
katelin => kate, kay, kaye
katelyn => kate, kay, kaye
katherine => cassie, cathy, kate, kathy, katy, kay, kaye, kit, kittie, lena, trina
kathleen => cassie, cathy, kathy, kathy, katy, kay, kit, kittie, lena, trina
kathryn => kathy
kendall => ken, kenny
kenneth => ken, kendrick, kenny
kent => ken, kendrick, kenny
keziah => kizza, kizzie
kimberley => kim
kimberly => kim
kingsley => king
kingston => king
kristen => chris
kristin => chris
kristine => chris, christy, crissy, kris, kristy, tina
kristy => chris
lafayette => fate, laffie
lamont => monty
laurence => larry, lon, lonny, lorne, lorry
lavina => ina, vina, viney
lavinia => ina, vina, viney
lawrence => larry, lon, lonny, lorne, lorry
lemuel => lem
lenora => lee, nora
leonard => len, lenny, leo, leon, lineau
leroy => l.r., lee, roy
leslie => les
lester => les
letitia => lettice, lettie, tish, titia
levi => lee
lidia => lyddy
lillah => lil, lilly, lily, lolly
lillian => lil, lilly, lolly
lincoln => link
linda => lindy, lynn
lisa => alice, melissa
lois => louise
lorenzo => loren
loretta => etta, lorrie, retta
lorraine => lorrie
louisa => eliza, lois, lou
louise => eliza, lois, lou
lucas => luke
lucias => luke
lucille => cille, lou, lu, lucy
lucinda => cindy, lou, lu, lucy
luella => ella, lu, lula
luther => luke
lydia => lyddy
lyndon => lindy, lynn
madeline => lena, maddy, madge, magda, maggie
magdelina => lena, madge, magda
mahala => hallie
marcus => mark
margaret => daisy, gretta, madge, maggie, maggy, marge, margery, margie, margie, margy, meg, midge, peg, peggy, peggy, rita
margaretta => daisy, gretta, madge, maggie, marge, margery, margie, meg, midge, peg, peggy, rita
marjorie => margie, margy
martha => marty, mat, mattie, patsy, patty
martin => marty
martina => tina
marvin => marv
mary => mae, mamie, mitzi, molly, polly
matilda => matty, maud, tilly
matthew => matt, mattie, matty, thias, thys
matthias => matt, thias, thys
maurice => morey
mehitabel => hetty, hitty, mabel, mitty
melinda => linda, lindy, lindy, lynn, mel, mindy
melissa => lisa, lissa, mel, milly, missy
mervyn => merv
michael => micah, mick, micky, mike
michelle => mickey
mildred => milly
millicent => milly, missy
minerva => minnie
miranda => mandy, mira, randy
miriam => mimi, mitzi
mitchell => mitch
montgomery => gum, monty
morris => morey
nancy => ann, nan, nan
napoleon => leon, nap, nappy
natalie => natty, nettie
nathan => nat, nate
nathaniel => nat, nate, nathan, natty, than
nicholas => claas, claes, nick
norbert => bert, norby
obadiah => diah, dyer, obed, obie
olive => livia, nollie, ollie
oliver => ollie
olivia => livia, nollie, ollie
oswald => ossy, ozzy, waldo
pamela => pam
parmelia => amelia, melia, milly
patience => pat, patty
patricia => pat, patsy, patty, tricia
patrick => paddy, pat, pate, patsy, peter
paula => lina, polly
paulina => lina, polly
pelegrine => perry
penelope => penny
percival => percy
peter => pate, pete, pete, pete
philetus => leet, phil
philinda => linda, lindy, lynn
philip => phil
phillip => phil, phil
prescott => pres, scott, scotty
priscilla => cilla, cissy, prissy
prudence => prudy, prue
rachel => shelly
rafaela => rafa
randolph => dolph, randy
raphael => ralph
raymond => ray, ray, ray
rebecca => becca, beck, becky, reba
regina => gina, reggie
reginald => naldo, reg, reggie, renny
relief => leafa
reuben => rube
ricardo => rick, ricky
richard => dick, dickie, dickon, dicky, rich, rick, rick, rick, ricky, ricky
robert => bob, bobby, dob, dobbin, hob, hobkin, rob, rob
roberta => bert, bertie, birdie, bobbie, bobbie, robbie
rodger => bobby, hodge, robby, robin, rod, roge, rupert
roger => bobby, hodge, robby, robin, rod, roge, rupert
roland => lanny, orlando, rollo, rolly
ronald => naldo, ron, ron, ron, ronny, ronny, ronny
rosabel => belle, rosa, rose, roz
rosabella => belle, rosa, rose, roz
rosalinda => linda, rosa, rose, roz
rosalyn => linda, rosa, rose, roz
roseann => ann, rose, rosie, roz
roseanna => ann, rose, rosie, roz
roseanne => ann
roxanna => ann, rose, roxie
roxanne => ann, rose, roxie
rudolph => dolph, olph, rolf, rudy
rudolphus => dolph, olph, rolf, rudy
russell => russ, russ, rusty
sabrina => brina
samuel => sam, sam, sammy, sammy
sandra => cassandra, sandy
sarah => sadie, sally
serena => rena
seymour => morey, see
shelton => shel, shelly, tony
sheridan => dan, danny, sher
shirley => lee, sherry, shirl
sidney => sid, syd
silas => si
simeon => si, sion
simon => si, sion
smith => smitty
solomon => sal, salmon, saul, sol, solly, zolly
sophia => sophie
stephan => steve
stephen => steph, steve
steven => steph, steve
stuart => stu
submit => mitty
sullivan => sully, van
susan => hannah, sue, sukey, susie, suzie
susannah => hannah, sue, sukey, susie
sylvester => si, sly, sy, syl, vessie, vester, vet
tabitha => tabby
terence => terry
teresa => terry
thaddeus => thad
theodore => ted, ted, teddy, teddy, theo
theresa => terry, tess, tessa, tessie, thirza, thursa, tracy
thom => tom, tommy
thomas => thom, thom, tom, tom, tom, tommy, tommy, tommy
timothy => tim, tim, tim, timmy, timmy, timmy
tobias => bias, toby
tryphena => phena
uriah => riah
valentine => felty
valeri => val
valerie => val, val, val
vanessa => essa, nessa, vanna
veronica => franky, frony, ron, ronie, ronna, ronnie, ronnie, vonnie
victor => vic
victoria => torie, tory, vic, vicki, vicky
vincent => vic, vin, vince, vinnie, vinny
vincenzo => vic, vin, vinnie, vinny
vinson => vinny
virginia => ginger, ginny, jane, jennie, virgy
wallace => wally
walter => wally, walt
washington => wash
wilber => bert, will
wilbur => willie, willy
wilfred => fred, will, willie
wilhelmina => mina, minnie, willie, wilma
will => fred
william => bela, bell, bill, billy, will, willie, willy
willie => fred
wilson => will, willie, willy
winfield => field, win, winny
winifred => freddie, winnet, winnie
winnifred => fred, freddie, freddy, winnie, winny
woodrow => drew, wood, woody
yvonne => vonna
zachariah => zach, zachy, zeke
zebedee => zeb
zedediah => diah, dyer, zed
zephaniah => zeph